247 430 346 257 165 248 382
241 111 192 353 241 192
35 394 454 232 480 23
38 194 388 380 388 23
85 297 262 245 66 446 213
294 14 167 86 232 315 384 291
234 206 222 108 206 95
232 291 300 300 374
495 134 180 22 97 350 111 350
66 85 8 268 349
86 471 327 224 6 151
315 315 434 390 6 294 315 111 6 230
23 371 485 480 498
38 220 437 382 251 493 180
79 56 434 229 353 315 294 291 399 34
418 485 206 190 189 156
53 353 206 431 189 103 222 357 103
66 374 69 183 165 334 36 262 247
257 247
42 156 118 11 206 370 273 474
85 247 69
22 495 251
165 233 233 444 392 174
140 38 134 251 140 158 60
232 97 232 248 461 296 498 248 480 97 398
446 85 121 165 262 494 422 12
207 333 12 357 232 189 206 116 431
0 122 357 234 357 42
425 182 66 377 268 127 182 332 262
194 482 254 485 441
186 233 399 8 449 386 399 92
82 172 151 320 421 423 48 249
386 469 144 85 394 259 295 95 300 260 364 85 182 21
435 303 190 303 248 11 190
245 194 366 184 245 436 208 165
216 480 35 300 296 226 247 158 73 158 346 216
75 306 335 357 289
411 4 357 108 97 404 273 171 189
85 297 349 355 245 245 233
307 26 267 424
388 436 386 165 320 300
357 326 307 357 231 381 421 234
66 213 326 233 396 7
233 186 127 66 36 165 364 85 349 10 349 233
246 12 222 424 190 190
165 349 349 297 262 36 233 229
189 102 307 103 190 326 234 331
146 180 158
225 353 192 79 86
113 423 225 490 424 434 214 106 424 182 74 423 101 294
220 260 291 140 350 296 398
247 35 251 398
309 286 184 178 140 17 220 158
262 262 165 337 16 399 459
64 241 364 209 399 487 165 295
91 335 102 273 12 417 140 102
449 165 165 417 396 91 245 95 253
313 3 327 447 353 20 172 167
425 295 396 247 459 163
172 164 327 225 161 155 62 189 2
234 190 357 335 12 42 441 164 59
498 140 119 140 377 146 485 201 260 73 17 479 247 55 354 247 158
42 442 0 59 189 431 348 295 285 303 273
251 22 17 20 99 22 480 455
396 436 239
179 60
436 66 16 121 399 127 396
297 295 334 452 244 367 8
66 349 436 355 262 95 268 295
171 141 207 404 116 273 222 357 273 42
388 498 158 226 35 251 140 23
213 213 349 428
303 307 10 295 12
442 304 313 389 357
66 151 225 232 161 111 6 192
172 99 6 327 269 192 300
296 38 493 382
86 327 292 423 492 192 2 300
158 158 55 251 296 146 226 38 17
137 16 174 66 334 349 269 158
102 150 0 60 411 381 206 424 326 307
215 60 97 257 485 2 260 38 140 495
357 303 42 97
86 79 47 2 284 225 276 75 315 47
186 169 297 346 36
425 431 234 307 190 42 417 474
165 459 386 459 64 245 469
459 245 36 262 349 459
304 232 421 425 353 234 273
353 206 171 59 53 339 326 162
257 146 296 158 158 493 158 51 38
326 456 303 169 42 431
296 17 493 62 371 158
34 447 86 6
239 127 36 449 268 12
498 116 347 201 257 485 251 175 216
16 182 36 66 305 165 245 262 399
273 42 454 231 424 381 418 176 10 272
231 109 497 222
12 29 441 424 190 418 91 353 190 389 460
349 355 8 233 36 207
229 165 239 165 232
399 399 8 452 295 400 165 165 85
364 165 245 85 208 386 128 230 144 388 364
324 350 140 17 498
86 50 292 400 34 44 292 167 241
485 226 35
17 17 232 158 286
459 493 22 146 382 23 353 36
32 2 327 434 315 111 102 358 315
140 180 57 140 165 60 455 257 175 150 180 194
36 326 85 399 386 165 295 245 295
244 239 239
296 99 97 36 112 38 479 482 430
227 17 158 485 35
315 192 167 172
296 248 23 180 158 480
430 251 350 140 140 285 309 146 493 38
74 167 206 315 321 86 50 434 294 315
12 333 169 190 97 442 189 103
173 347 423 300 229
239 158 450 399 36 236 382
246 205 295
296 382 17 493 455 382 180
345 0 389 42
175 480 220 251 480
399 165 386 349 183 66 208 232 85 127 433
382 498 291 140 134 485 290
186 459 85 184 247 262 386 459 66
159 165 485 2 112 23 177 350 260 87
165 65 291 46 87 99 498
180 192 107 399 434 327 353 269 62
151 315 182 225 471 56
320 444 435 279 327 225 102 315
12 431 199 171 435
248 485 216 175 62
382 350 247 180 485 17 97 485
206 144 357 206 169 417
334 245 233
88 357 315 59
251 165 312 251 46 296 498 485
456 386 396 436 158 459 349 245 386 279
176 417
245 182 366 449 436 349
4 326 485 206 0 10 206 232 190 456
134 119 62 291
245 144 431 295 260
190 0 466 207 122 307 108
65 320 251 291 480
192 86 294 269
246 232 108
92 64 85 165 232 34
430 493
235 206 82 400 151 20
207 91 336 12 196 207 171 273 303 389 42 231
266 86
158 140 257 87 330 180
455 35 17 165 260 3 296 99 22
35 480 20 296 17 296 22
371 493 17 38
111 248 269 86 86 164 320 443 315 240
194 241 173 22 485
121 297 239 36 8 262 407 165
425 206 451 430 308
262 8 394 66 173 262 334 417
60 382 17 226
6 315 352 86 151 327
286 220 38 232 498
38 498 350 111 180 140 194 286 180 247
66 229 16 233
16 396 232 69 127 245 355 449 182 366 233 262 386 399
389 273 307 273 485 276 59
174 396 399 85 295 436 326 386
103 485 164 0 150 234 345
326 42 389 122 135 108 206
469 144 85 261 245 489 459
228 469 66 233 262 334 295
273 265 307 460 12 353
267 135 303 190 29 273 417 206
417 474 313 357
449 452 449 165 85
367 165 452 169 436 349
495 286 251 60 495 146 146 286 23 112 140
180 180 498 65 286 388 485 382 251
367 229 399 77 423 162 47 20 74
161 47 50 50 421 81 374
0 420 12 389 169 97 357 421 491
107 82 6
388 23 158 251
158 20 350 485 498 498
10 66 16 262 85 165 66 41 233
66 355 349 8 334
42 64 357 206 425 122 497 234 108
498 165 485 226 350 17 37 165 180
12 232 91 116 53 333 234 273 190 234
173 361 165 350 215 493 388 493
206 435 431 477 12 122
86 327 6
298 493 479 498
165 7 436 165 386 66 390 229 295 396
213 459 459 386 337 386 386
234 303 389 29 431 12 206 273
485 295 234 442 190 206 348 326 171 441 288
288 152 357 424 29 12 485 272 206 42
200 386 211 459 8
396 494
357 424 234 222 97 326 442
66 245 295 295 16
333 142 158 206
192
29 156 477 156
182 66 66 245 233 367 233 36
390 36 260 66 233 262
267 190 10 315 273 357 410 303
337 386 295 337 367
308 326 306 326 10
